0 2 2 ONSERVICE 11
1 3 2 FREE 10
2 1 5 FREE 10
3 3 2 PARTIALLY_FREE 10 4 5
4 1 1 FREE 10
5 5 3 FREE 10
6 1 2 FREE 10
7 4 3 FREE 10
8 1 4 FREE 10
